1871,1871,1871,1871,1871,1871,1871,1871,1742,1742,1742,1742,1871,1871,1871,1871,1871,1871,1871,1871,1871,1871,1871,1871,1871,1871,1871,1871,1871,1871,1871,1871,1871,1871,1871,1871,1871,1871,1871,1871,1871,1871,1871,1871,1871,1871,1871,1871,1871,1871,1871,1871,1871,1871,1871,1871,1871,1871,1871,1871
1871,1871,1871,1871,1871,1871,1871,1871,1742,1742,1742,1742,1871,1871,1871,1871,1871,1871,1871,1871,1871,1871,1871,1871,1871,1871,1871,1871,1871,1871,1871,1871,1871,1871,1871,1871,1871,1871,1871,1871,1871,1871,1871,1871,1871,1871,1871,1871,1871,1871,1871,1871,1871,1871,1871,1871,1871,1871,1871,1871
1871,1871,1871,1871,1871,1871,1871,1871,1742,1742,1742,1742,1871,1871,1871,1871,1871,1871,1871,1871,1871,1871,1871,1871,1871,1871,1871,1871,1871,1871,1871,1871,1871,1871,1871,1871,1871,1871,1871,1871,1871,1871,1871,1871,1871,1871,1871,1871,1871,1871,1871,1871,1871,1871,1871,1871,1871,1871,1871,1871
1871,1871,1871,1871,1871,1871,1871,1871,1742,1742,1742,1742,1871,1871,1871,1871,1871,1871,1871,1871,1871,1871,1871,1871,1871,1871,1871,1871,1871,1871,1871,1871,1871,1871,1871,1871,1871,1871,1871,1871,1871,1871,1871,1871,1871,1871,1871,1871,1871,1871,1871,1871,1871,1871,1871,1871,1871,1871,1871,1871
1871,1871,1871,1871,1871,1871,1871,1871,1742,1742,1742,1742,1871,1871,1871,1871,1871,1871,1871,1871,1871,1871,1871,1871,1871,1871,1871,1871,1871,1871,1871,1871,1871,1871,1871,1871,1871,1871,1871,1871,1871,1871,1871,1871,1871,1871,1871,1871,1871,1871,1871,1871,1871,1871,1871,1871,1871,1871,1871,1871
1871,1871,1871,1871,1871,1871,1871,1871,1742,1742,1742,1742,1871,1871,1871,1871,1871,1871,1871,1871,1871,1871,1871,1871,1871,1871,1871,1871,1871,1871,1871,1871,1871,1871,1871,1871,1871,1871,1871,1871,1871,1871,1871,1871,1871,1871,1871,1871,1871,1871,1871,1871,1871,1871,1871,1871,1871,1871,1871,1871
1871,1871,1871,1871,1871,1871,1871,1871,1742,1742,1742,1742,1871,1871,1871,1871,1871,1871,1871,1871,1871,1871,1871,1871,1871,1871,1871,1871,1871,1871,1871,1871,1871,1871,1871,1871,1871,1871,1871,1871,1871,1871,1871,1871,1871,1871,1871,1871,1871,1871,1871,1871,1871,1871,1871,1871,1871,1871,1871,1871
1871,1871,1871,1871,1871,1871,1871,1871,1742,1742,1742,1742,1871,1871,1871,1871,1871,1871,1871,1871,1871,1871,1871,1871,1871,1871,1871,1871,1871,1871,1871,1871,1871,1871,1871,1871,1871,1871,1871,1871,1871,1871,1871,1871,1871,1871,1871,1871,1871,1871,1871,1871,1871,1871,1871,1871,1871,1871,1871,1871
1871,1871,1871,1871,1871,1871,1871,1871,1742,1742,1742,1742,1871,1871,1871,1871,1871,1871,1871,1871,1871,1871,1871,1871,1871,1871,1871,1871,1871,1871,1871,1871,1871,1871,1871,1871,1871,1871,1871,1871,1871,1871,1871,1871,1871,1871,1871,1871,1871,1871,1871,1871,1871,1871,1871,1871,1871,1871,1871,1871
1871,1871,1871,1871,1871,1871,1871,1871,1742,1742,1742,1742,1871,1871,1871,1871,1871,1871,1871,1871,1871,1871,1871,1871,1871,1871,1871,1871,1871,1871,1871,1871,1871,1871,1871,1871,1871,1871,1871,1871,1871,1871,1871,1871,1871,1871,1871,1871,1871,1871,1871,1871,1871,1871,1871,1871,1871,1871,1871,1871
1871,1871,1871,1871,1871,1871,1871,1871,1742,1742,1742,1742,1871,1871,1871,1871,1871,1871,1871,1871,1871,1871,1871,1871,1871,1871,1871,1871,1871,1871,1871,1871,1871,1871,1871,1871,1871,1871,1871,1871,1871,1871,1871,1871,1871,1871,1871,1871,1871,1871,1871,1871,1871,1871,1871,1871,1871,1871,1871,1871
1871,1871,1871,1871,1871,1871,1871,1871,1742,1742,1742,1742,1871,1871,1871,1871,1871,1871,1871,1871,1871,1871,1871,1871,1871,1871,1871,1871,1871,1871,1871,1871,1871,1871,1871,1871,1871,1871,1871,1871,1871,1871,1871,1871,1871,1871,1871,1871,1871,1871,1871,1871,1871,1871,1871,1871,1871,1871,1871,1871
1495,1495,1495,1495,1495,1495,1742,1742,1742,1742,1742,1742,1742,1742,1871,1871,1871,1871,1871,1871,1871,1871,1871,1871,1871,1871,1871,1871,1871,1871,1871,1871,1871,1871,1871,1871,1871,1871,1871,1871,1871,1871,1871,1871,1871,1871,1871,1871,1871,1871,1871,1871,1871,1871,1871,1871,1871,1871,1871,1871
1495,1495,1495,1495,1495,1495,1742,1742,1742,1742,1742,1742,1742,1742,1871,1871,1871,1871,1871,1871,1871,1871,1871,1871,1871,1871,1871,1871,1871,1871,1871,1871,1871,1871,1871,1871,1871,1871,1871,1871,1871,1871,1871,1871,1871,1871,1871,1871,1871,1871,1871,1871,1871,1871,1871,1871,1871,1871,1871,1871
1495,1495,1495,1495,1495,1742,1742,1742,1742,1742,1742,1742,1742,1742,1742,1871,1871,1871,1871,1871,1871,1871,1871,1871,1871,1871,1871,1871,1871,1871,1871,1871,1871,1871,1871,1871,1871,1871,1871,1871,1871,1871,1871,1871,1871,1871,1871,1871,1871,1871,1871,1871,1871,1871,1871,1871,1871,1871,1871,1871
1495,1495,1495,1495,1742,1742,1742,1742,1742,1742,1742,1742,1742,1742,1742,1742,1871,1871,1871,1871,1871,1871,1871,1871,1871,1871,1871,1871,1871,1871,1871,1871,1871,1871,1871,1871,1871,1871,1871,1871,1871,1871,1871,1871,1871,1871,1871,1871,1871,1871,1871,1871,1871,1871,1871,1871,1871,1871,1871,1871
1870,1870,1871,1747,1746,1747,1742,1742,1742,1742,1742,1742,1742,1742,1742,1742,1742,1871,1871,1871,1871,1871,1871,1871,1871,1871,1871,1871,1871,1871,1871,1871,1871,1871,1871,1871,1871,1871,1871,1871,1871,1871,1871,1871,1871,1871,1871,1871,1871,1871,1871,1871,1871,1871,1871,1871,1871,1871,1871,1871
1870,1871,1747,1747,1747,1747,1742,1742,1742,1742,1742,1742,1742,1742,1742,1742,1742,1871,1871,1871,1871,1871,1871,1871,1871,1871,1871,1871,1871,1871,1871,1871,1871,1871,1871,1871,1871,1871,1871,1871,1871,1871,1871,1871,1871,1871,1871,1871,1871,1871,1871,1871,1871,1871,1871,1871,1871,1871,1871,1871
1871,1747,1747,1747,1747,1747,1742,1490,1491,1742,1742,1742,1742,1742,1742,1490,1491,1871,1871,1871,1871,1871,1871,1871,1871,1871,1871,1871,1871,1871,1871,1871,1871,1871,1871,1871,1871,1871,1871,1871,1871,1871,1871,1871,1871,1871,1871,1871,1871,1871,1871,1871,1871,1871,1871,1871,1871,1871,1871,1871
1747,1747,1747,1747,1747,1747,1742,1553,1554,1743,1744,1745,1746,1747,1742,1553,1554,1871,1871,1871,1871,1871,1871,1871,1871,1871,1871,1871,1871,1871,1871,1871,1871,1871,1871,1871,1871,1871,1871,1871,1871,1871,1871,1871,1871,1871,1871,1871,1871,1871,1871,1871,1871,1871,1871,1871,1871,1871,1871,1871
1747,1747,1747,1747,1747,1747,1742,1616,1617,1806,1807,1808,1809,1810,1742,1616,1617,1871,1871,1871,1871,1871,1871,1871,1871,1871,1871,1871,1871,1871,1871,1871,1871,1871,1871,1871,1871,1871,1871,1871,1871,1871,1871,1871,1871,1871,1871,1871,1871,1871,1871,1871,1871,1871,1871,1871,1871,1871,1871,1871
1747,1747,1747,1747,1747,1747,1742,1679,1680,1869,1870,1871,1872,1873,1742,1679,1680,1871,1871,1871,1871,1871,1871,1871,1871,1871,1871,1871,1871,1871,1871,1871,1871,1871,1871,1871,1871,1871,1871,1871,1871,1871,1871,1871,1871,1871,1871,1871,1871,1871,1871,1871,1871,1871,1871,1871,1871,1871,1871,1871
1747,1747,1747,1747,1747,1747,1490,1491,1931,1932,1933,1934,1935,1936,1742,1742,1742,1871,1871,1871,1871,1871,1871,1871,1871,1871,1871,1871,1871,1871,1871,1871,1871,1871,1871,1871,1871,1871,1871,1871,1871,1871,1871,1871,1871,1871,1871,1871,1871,1871,1871,1871,1871,1871,1871,1871,1871,1871,1871,1871
1747,1747,1747,1747,1747,1747,1553,1554,1994,1995,1996,1997,1998,1999,1742,1742,1742,1871,1871,1871,1871,1871,1871,1871,1871,1871,1871,1871,1871,1871,1871,1871,1871,1871,1871,1871,1871,1871,1871,1871,1871,1871,1871,1871,1871,1871,1871,1871,1871,1871,1871,1871,1871,1871,1871,1871,1871,1871,1871,1871
1747,1747,1747,1747,1747,1747,1616,1617,2057,2058,2059,2060,2061,2062,1742,1742,1742,1871,1871,1871,1871,1871,1871,1871,1871,1871,1871,1871,1871,1871,1871,1871,1871,1871,1871,1871,1871,1871,1871,1871,1871,1871,1871,1871,1871,1871,1871,1871,1871,1871,1871,1871,1871,1871,1871,1871,1871,1871,1871,1871
1747,1747,1747,1745,1747,1747,1679,1680,1742,1742,1742,1742,1742,1742,1742,1742,1742,1871,1871,1871,1871,1871,1871,1871,1871,1871,1871,1871,1871,1871,1871,1871,1871,1871,1871,1871,1871,1871,1871,1871,1871,1871,1871,1871,1871,1871,1871,-1,-1,1871,1871,1871,1871,1871,1871,1871,1871,1871,1871,1871
1747,1747,1747,1747,1747,1747,1742,1742,1742,1742,1742,1742,1743,1744,1745,1746,1747,1871,1871,1871,1871,1871,1871,1871,1871,1871,1871,1871,1871,1871,1871,1871,1871,1871,1871,1871,1871,1871,1871,1871,1871,1871,1871,1871,1871,1871,1871,1871,1871,1871,1871,1871,1871,1871,1871,1871,1871,1871,1871,1871
1747,1747,1747,1747,1747,1747,1742,1742,1742,1742,1742,1805,1806,1807,1808,1809,1810,1871,1871,1871,1871,1871,1871,1871,1871,1871,1871,1871,1871,1871,1871,1871,1871,1871,1871,1871,1871,1871,1871,1871,1871,1871,1871,1871,1871,1871,1871,1871,1871,1871,1871,1871,1871,1871,1871,1871,1871,1871,1871,1871
1747,1747,1747,1747,1747,1747,1742,1742,1742,1742,1742,1868,1869,1870,1871,1872,1873,1871,1871,1871,1871,1871,1871,1871,1871,1871,1871,1871,1871,1871,1871,1871,1871,1871,1871,1871,1871,1871,1871,1871,1871,1871,1871,1871,1871,1871,1871,1871,1871,1871,1871,1871,1871,1871,1871,1871,1871,1871,1871,1871
1747,1747,1747,1747,1747,1747,1742,1742,1742,1742,1742,1931,1932,1933,1934,1935,1936,1871,1871,1871,1871,1871,1871,1871,1871,1871,1871,1871,1871,1871,1871,1871,1871,1871,1871,1871,1871,1871,1871,1871,1871,1871,1871,1871,1871,1871,1871,1871,1871,1871,1871,1871,1871,1871,1871,1871,1871,1871,1871,1871
2057,2058,1747,1747,1747,2062,1742,1742,1742,1742,1742,1994,1995,1996,1997,1998,1999,1871,1871,1871,1871,1871,1871,1871,1871,1871,1871,1871,1871,1871,1871,1871,1871,1871,1871,1871,1871,1871,1871,1871,1871,1871,1871,1871,1871,1871,1871,1871,1871,1871,1871,1871,1871,1871,1871,1871,1871,1871,1871,1871
1742,1742,1742,1742,1490,1491,1742,1742,1742,1742,1742,2057,2058,2059,2060,2061,2062,1871,1871,1871,1871,1871,1871,1871,1871,1871,1871,1871,1871,1871,1871,1871,1871,1871,1871,1871,1871,1871,1871,1871,1871,1871,1871,1871,1871,1871,1871,1871,1871,1871,1871,1871,1871,1871,1871,1871,1871,1871,1871,1871
1742,1747,1747,1747,1553,1554,1742,1742,1742,1743,1744,1745,1746,1747,1742,1742,1742,1871,1871,1871,1871,1871,1871,1871,1871,1871,1871,1871,1871,1871,1871,1871,1871,1871,1871,1871,1871,1871,1871,1871,1871,1871,1871,1871,1871,1871,1871,1871,1871,1871,1871,1871,1871,1871,1871,1871,1871,1871,1871,1871
1747,1747,1747,1747,1616,1617,1742,1742,1805,1806,1807,1808,1809,1810,1742,1742,1742,1871,1871,1871,1871,1871,1871,1871,1871,1871,1871,1871,1871,1871,1871,1871,1871,1871,1871,1871,1871,1871,1871,1871,1871,1871,1871,1871,1871,1871,1871,1871,1871,1871,1871,1871,1871,1871,1871,1871,1871,1871,1871,1871
1747,1747,1747,1747,1679,1680,1742,1742,1868,1869,1870,1871,1872,1873,1742,1742,1742,1871,1871,1871,1871,1871,1871,1871,1871,1871,1871,1871,1871,1871,1871,1871,1871,1871,1871,1871,1871,1871,1871,1871,1871,1871,1871,1871,1871,1871,1871,1871,1871,1871,1871,1871,1871,1871,1871,1871,1871,1871,1871,1871
1747,1747,1747,1747,1747,1747,1742,1742,1931,1932,1933,1934,1935,1936,1742,1742,1742,1871,1871,1871,1871,1871,1871,1871,1871,1871,1871,1871,1871,1871,1871,1871,1871,1871,1871,1871,1871,1871,1871,1871,1871,1871,1871,1871,1871,1871,1871,1871,1871,1871,1871,1871,1871,1871,1871,1871,1871,1871,1871,1871
1495,1495,1747,1747,1747,1742,1742,1742,1742,1995,1996,1997,1998,1999,1742,1742,1871,1871,1871,1871,1871,1871,1871,1871,1871,1871,1871,1871,1871,1871,1871,1871,1871,1871,1871,1871,1871,1871,1871,1871,1871,1871,1871,1871,1871,1871,1871,1871,1871,1871,1871,1871,1871,1871,1871,1871,1871,1871,1871,1871
1495,1495,1495,1742,1742,1742,1742,1742,1742,2058,2059,2060,2061,2062,1742,1871,1871,1871,1871,1871,1871,1871,1871,1871,1871,1871,1871,1871,1871,1871,1871,1871,1871,1871,1871,1871,1871,1871,1871,1871,1871,1871,1871,1871,1871,1871,1871,1871,1871,1871,1871,1871,1871,1871,1871,1871,1871,1871,1871,1871
1495,1495,1495,1495,1742,1742,1742,1742,1742,1742,1742,1742,1742,1742,1871,1871,1871,1871,1871,1871,1871,1871,1871,1871,1871,1871,1871,1871,1871,1871,1871,1871,1871,1871,1871,1871,1871,1871,1871,1871,1871,1871,1871,1871,1871,1871,1871,1871,1871,1871,1871,1871,1871,1871,1871,1871,1871,1871,1871,1871
1871,1871,1871,1871,1871,1871,1871,1742,1742,1742,1742,1871,1871,1871,1871,1871,1871,1871,1871,1871,1871,1871,1871,1871,1871,1871,1871,1871,1871,1871,1871,1871,1871,1871,1871,1871,1871,1871,1871,1871,1871,1871,1871,1871,1871,1871,1871,1871,1871,1871,1871,1871,1871,1871,1871,1871,1871,1871,1871,1871
1871,1871,1871,1871,1871,1871,1871,1742,1742,1742,1742,1871,1871,1871,1871,1871,1871,1871,1871,1871,1871,1871,1871,1871,1871,1871,1871,1871,1871,1871,1871,1871,1871,1871,1871,1871,1871,1871,1871,1871,1871,1871,1871,1871,1871,1871,1871,1871,1871,1871,1871,1871,1871,1871,1871,1871,1871,1871,1871,1871
1871,1871,1871,1871,1871,1871,1871,1742,1742,1742,1742,1871,1871,1871,1871,1871,1871,1871,1871,1871,1871,1871,1871,1871,1871,1871,1871,1871,1871,1871,1871,1871,1871,1871,1871,1871,1871,1871,1871,1871,1871,1871,1871,1871,1871,1871,1871,1871,1871,1871,1871,1871,1871,1871,1871,1871,1871,1871,1871,1871
1871,1871,1871,1871,1871,1871,1871,1742,1742,1742,1742,1871,1871,1871,1871,1871,1871,1871,1871,1871,1871,1871,1871,1871,1871,1871,1871,1871,1871,1871,1871,1871,1871,1871,1871,1871,1871,1871,1871,1871,1871,1871,1871,1871,1871,1871,1871,1871,1871,1871,1871,1871,1871,1871,1871,1871,1871,1871,1871,1871
1871,1871,1871,1871,1871,1871,1871,1742,1742,1742,1742,1871,1871,1871,1871,1871,1871,1871,1871,1871,1871,1871,1871,1871,1871,1871,1871,1871,1871,1871,1871,1871,1871,1871,1871,1871,1871,1871,1871,1871,1871,1871,1871,1871,1871,1871,1871,1871,1871,1871,1871,1871,1871,1871,1871,1871,1871,1871,1871,1871
1871,1871,1871,1871,1871,1871,1871,1742,1742,1742,1742,1871,1871,1871,1871,1871,1871,1871,1871,1871,1871,1871,1871,1871,1871,1871,1871,1871,1871,1871,1871,1871,1871,1871,1871,1871,1871,1871,1871,1871,1871,1871,1871,1871,1871,1871,1871,1871,1871,1871,1871,1871,1871,1871,1871,1871,1871,1871,1871,1871
1871,1871,1871,1871,1871,1871,1871,1742,1742,1742,1742,1871,1871,1871,1871,1871,1871,1871,1871,1871,1871,1871,1871,1871,1871,1871,1871,1871,1871,1871,1871,1871,1871,1871,1871,1871,1871,1871,1871,1871,1871,1871,1871,1871,1871,1871,1871,1871,1871,1871,1871,1871,1871,1871,1871,1871,1871,1871,1871,1871
1871,1871,1871,1871,1871,1871,1871,1742,1742,1742,1742,1871,1871,1871,1871,1871,1871,1871,1871,1871,1871,1871,1871,1871,1871,1871,1871,1871,1871,1871,1871,1871,1871,1871,1871,1871,1871,1871,1871,1871,1871,1871,1871,1871,1871,1871,1871,1871,1871,1871,1871,1871,1871,1871,1871,1871,1871,1871,1871,1871
1871,1871,1871,1871,1871,1871,1871,1742,1742,1742,1742,1871,1871,1871,1871,1871,1871,1871,1871,1871,1871,1871,1871,1871,1871,1871,1871,1871,1871,1871,1871,1871,1871,1871,1871,1871,1871,1871,1871,1871,1871,1871,1871,1871,1871,1871,1871,1871,1871,1871,1871,1871,1871,1871,1871,1871,1871,1871,1871,1871
1871,1871,1871,1871,1871,1871,1871,1742,1742,1742,1742,1871,1871,1871,1871,1871,1871,1871,1871,1871,1871,1871,1871,1871,1871,1871,1871,1871,1871,1871,1871,1871,1871,1871,1871,1871,1871,1871,1871,1871,1871,1871,1871,1871,1871,1871,1871,1871,1871,1871,1871,1871,1871,1871,1871,1871,1871,1871,1871,1871
1871,1871,1871,1871,1871,1871,1871,1742,1742,1742,1742,1871,1871,1871,1871,1871,1871,1871,1871,1871,1871,1871,1871,1871,1871,1871,1871,1871,1871,1871,1871,1871,1871,1871,1871,1871,1871,1871,1871,1871,1871,1871,1871,1871,1871,1871,1871,1871,1871,1871,1871,1871,1871,1871,1871,1871,1871,1871,1871,1871
1871,1871,1871,1871,1871,1871,1871,1742,1742,1742,1742,1871,1871,1871,1871,1871,1871,1871,1871,1871,1871,1871,1871,1871,1871,1871,1871,1871,1871,1871,1871,1871,1871,1871,1871,1871,1871,1871,1871,1871,1871,1871,1871,1871,1871,1871,1871,1871,1871,1871,1871,1871,1871,1871,1871,1871,1871,1871,1871,1871
