2742,2742,2742,2742,2742,2742,2742,2742,2742,2742,2742,2742,2742,2742,2742,2742,2742,2742,2742,2742,2742,2742,2742,2742,2742,2742,2742,2742,2742,2742,2742,2742,2742,2742,2742,2742,2742,2742,2742,2742,2742,2742,2742,2742,2742,2742,2742,2742,2742,2742
2742,2742,2742,2742,2742,2742,2742,2742,2742,2742,2742,2742,2742,2742,2742,2742,2742,2742,2742,2742,2742,2742,2742,2742,2742,2742,2742,2742,2742,2742,2742,2742,2742,2742,2742,2742,2742,2742,2742,2742,2742,2742,2742,2742,2742,2742,2742,2742,2742,2742
2742,2742,2742,2742,2742,2742,2742,2742,2742,2742,2742,2742,2742,2742,2742,2742,2742,2742,2742,2742,2742,2742,2742,2742,2742,2742,2742,2742,2742,2742,2742,2742,2742,2742,2742,2742,2742,2742,2742,2742,2742,2742,2742,2742,2742,2742,2742,2742,2742,2742
2742,2742,2742,2742,2742,2742,2742,2742,2742,2742,2742,2742,2742,2742,2742,2742,2742,2742,2742,2742,2742,2742,2742,2742,2742,2742,2742,2742,2742,2742,2742,2742,2742,2742,2742,2742,2742,2742,2742,2742,2742,2742,2742,2742,2742,2742,2742,2742,2742,2742
2742,2742,2742,2742,2742,2742,2742,2742,2742,2742,2742,2742,2742,2742,2742,2742,2742,2742,2742,2742,2742,2742,2742,2742,2742,2742,2742,2742,2742,2742,2742,2742,2742,2742,2742,2742,2742,2742,2742,2742,2742,2742,2742,2742,2742,2742,2742,2742,2742,2742
2742,2742,2742,2742,2742,2742,2742,2742,2742,2742,2742,2742,2742,2742,2742,2742,2742,2742,2742,2742,2742,2742,2742,2742,2742,2742,2742,2742,2742,2742,2742,2742,2742,2742,2742,2742,2742,2742,2742,2742,2742,2742,2742,2742,2742,2742,2742,2742,2742,2742
2742,2742,2742,2742,2742,2742,2742,2742,2742,2742,2742,2742,2742,2742,2742,2742,2742,2742,2742,2742,2742,2742,2742,2742,2742,2742,2742,2742,2742,2742,2742,2742,2742,2742,2742,2742,2742,2742,2742,2742,2742,2742,2742,2742,2742,2742,2742,2742,2742,2742
2742,2742,2742,2742,2742,2742,2742,2742,2742,2742,2742,2742,2742,2742,2742,2742,2742,2742,2742,2742,2742,2742,2742,2742,2742,2742,2742,2742,2742,2742,2742,2742,2742,2742,2742,2742,2742,2742,2742,2742,2742,2742,2742,2742,2742,2742,2742,2742,2742,2742
2742,2742,2742,2742,2742,2742,2742,2742,2742,2742,2742,2742,2742,2742,2742,2742,2742,2742,2742,2742,2742,2742,2742,2742,2742,2742,2742,2742,2742,2742,2742,2742,2742,2742,2742,2742,2742,2742,2742,2742,2742,2742,2742,2742,2742,2742,2742,2742,2742,2742
2742,2742,2742,2742,2742,2742,2742,2742,2742,2742,2742,2742,2742,2742,2742,2742,2742,2742,2742,2742,2742,2742,2742,2742,2742,2742,2742,2742,2742,2742,2742,2742,2742,2742,2742,2742,2742,2742,2742,2742,2742,2742,2742,2742,2742,2742,2742,2742,2742,2742
2742,2742,2742,2742,2742,2742,2742,2742,2742,2742,2742,2742,2742,2742,2742,2742,2742,2742,2742,2742,2742,2742,2742,2742,2742,2742,2742,2742,2742,2742,2742,2742,2742,2742,2742,2742,2742,2742,2742,2742,2742,2742,2742,2742,2742,2742,2742,2742,2742,2742
2742,2742,2742,2742,2742,2742,2742,2742,2742,2742,2742,2742,2742,2742,2742,2742,2742,2742,2742,2742,2742,2742,2742,2742,2742,2742,2742,2742,2742,2742,2742,2742,2742,2742,2742,2742,2742,2742,2742,2742,2742,2742,2742,2742,2742,2742,2742,2742,2742,2742
2742,2742,2742,2742,2742,2742,2742,2742,2742,2742,2742,2742,2742,2742,2742,2742,2742,2742,2742,2742,2742,2742,2742,2742,2742,2742,2742,2742,2742,2742,2742,2742,2742,2742,2742,2742,2742,2742,2742,2742,2742,2742,2742,2742,2742,2742,2742,2742,2742,2742
2742,2742,2742,2742,2742,2742,2742,2742,2742,2742,2742,2742,2742,2742,2742,2742,2742,2742,2742,2742,2742,2742,2742,2742,2742,2742,2742,2742,2742,2742,2742,2742,2742,2742,2742,2742,2742,2742,2742,2742,2742,2742,2742,2742,2742,2742,2742,2742,2742,2742
2742,2742,2742,2742,2742,2742,2742,2742,2742,2742,2742,2742,2742,2742,2742,2742,2742,2742,2742,2742,2742,2742,2742,2742,2742,2742,2742,2742,2742,2742,2742,110,110,110,110,110,110,110,110,110,110,110,110,110,2742,2742,2742,2742,2742,2742
2742,2742,2742,2742,2742,2742,2742,2742,2742,2742,2742,2742,2742,2742,2742,2742,2742,2742,2742,2742,2742,2742,2742,2742,2742,2742,2742,2742,2742,2742,110,110,110,110,110,110,110,110,110,110,110,110,110,110,110,2742,2742,2742,2742,2742
2742,2742,2742,2742,2742,2742,2742,2742,2742,2742,2742,2742,2742,2742,2742,2742,2742,2742,2742,2742,2742,2742,2742,2742,2742,2742,2742,2742,2742,2742,110,110,110,110,110,110,110,110,110,110,110,110,110,110,110,2742,2742,2742,2742,2742
2742,2742,2742,2742,2742,2742,2742,2742,2742,2742,2742,2742,2742,2742,2742,2742,2742,2742,2742,2742,2742,2742,2742,2742,2742,2742,2742,2742,2742,2742,110,110,110,110,110,110,110,110,110,110,110,110,110,110,110,2742,2742,2742,2742,2742
2742,2742,2742,2742,2742,2742,2742,2742,2742,2742,2742,2742,2742,2742,2742,2742,2742,2742,2742,2742,2742,2742,2742,2742,2742,2742,2742,2742,2742,2742,110,110,110,110,110,110,110,110,110,110,110,110,110,110,110,2742,2742,2742,2742,2742
2742,2742,2742,2742,2742,2742,2742,2742,2742,2742,2742,2742,2742,2742,2742,2742,2742,2742,2742,2742,2742,2742,2742,2742,2742,2742,2742,2742,2742,2742,110,110,110,110,110,110,110,110,110,110,110,110,110,110,110,2742,2742,2742,2742,2742
2742,2742,2742,2742,2742,2742,2742,2742,2742,2742,2742,2742,2742,2742,2742,2742,2742,2742,2742,2742,2742,2742,2742,2742,2742,2742,2742,2742,2742,2742,110,110,110,110,110,110,110,110,110,110,110,110,110,110,110,2742,2742,2742,2742,2742
2742,2742,2742,2742,2742,2742,2742,2742,2742,2742,2742,2742,2742,2742,2742,2742,2742,2742,2742,2742,2742,2742,2742,2742,2742,2742,2742,2742,2742,2742,110,110,110,110,110,110,110,110,110,110,110,110,110,110,110,2742,2742,2742,2742,2742
2742,2742,2742,2742,2742,2742,2742,2742,2742,2742,2742,2742,2742,2742,2742,2742,2742,2742,2742,2742,2742,2742,2742,2742,2742,2742,2742,2742,2742,2742,110,110,110,110,110,110,110,110,110,110,110,110,110,110,110,2742,2742,2742,2742,2742
2742,2742,2742,2742,2742,2742,2742,2742,2742,2742,2742,2742,2742,2742,2742,2742,2742,2742,2742,2742,2742,2742,2742,2742,2742,2742,2742,2742,2742,2742,110,110,110,110,110,110,110,110,110,110,110,110,110,110,110,2742,2742,2742,2742,2742
2742,2742,2742,2742,2742,2742,2742,2742,2742,2742,2742,2742,2742,2742,2742,2742,2742,2742,2742,2742,2742,2742,2742,2742,2742,2742,2742,2742,2742,2742,110,110,110,110,110,110,110,110,110,110,110,110,110,110,110,2742,2742,2742,2742,2742
2742,2742,2742,2742,2742,2742,2742,2742,2742,2742,2742,2742,2742,2742,2742,2742,2742,2742,2742,2742,2742,2742,2742,2742,2742,2742,2742,2742,2742,2742,110,110,110,110,110,110,110,110,110,110,110,110,110,110,110,2742,2742,2742,2742,2742
2742,2742,2742,2742,2742,2742,2742,2742,2742,2742,2742,2742,2742,2742,2742,2742,2742,2742,2742,2742,2742,2742,2742,2742,2742,2742,2742,2742,2742,2742,110,110,110,110,110,110,110,110,110,110,110,110,110,110,110,2742,2742,2742,2742,2742
2742,2742,2742,2742,2742,2742,2742,2742,2742,2742,2742,2742,2742,2742,2742,2742,2742,2742,2742,2742,2742,2742,2742,2742,2742,2742,2742,2742,2742,2742,110,110,110,110,110,110,110,110,110,110,110,110,110,110,110,2742,2742,2742,2742,2742
2742,2742,2742,2742,2742,2742,2742,2742,2742,2742,2742,2742,2742,2742,2742,2742,2742,2742,2742,2742,2742,2742,2742,2742,2742,2742,2742,2742,2742,2742,2742,110,110,110,110,110,110,110,110,110,110,110,110,110,2173,2742,2742,2742,2742,2742
2742,2742,2742,2742,2742,2742,2742,2742,2742,2742,2742,2742,2742,2742,2742,2742,2742,2742,2742,2742,2742,2742,2742,2742,2742,2742,2742,2742,2742,2742,2742,2742,2742,2742,2742,2742,2742,2742,2742,2742,2742,2742,2742,2742,2742,2742,2742,2742,2742,2742
2742,2742,2742,2742,2742,2742,2742,2742,2742,2742,2742,2742,2742,2742,2742,2742,2742,2742,2742,2742,2742,2742,2742,2742,2742,2742,2742,2742,2742,2742,2742,2742,2742,2742,2742,2742,2742,2742,2742,2742,2742,2742,2742,2742,2742,2742,2742,2742,2742,2742
2742,2742,2742,2742,2742,2742,2742,2742,2742,2742,2742,2742,2742,2742,2742,2742,2742,2742,2742,2742,2742,2742,2742,2742,2742,2742,2742,2742,2742,2742,2742,2742,2742,2742,2742,2742,2742,2742,2742,2742,2742,2742,2742,2742,2742,2742,2742,2742,2742,2742
2742,2742,2742,2742,2742,2742,2742,2742,2742,2742,2742,2742,2742,2742,2742,2742,2742,2742,2742,2742,2742,2742,2742,2742,2742,2742,2742,2742,2742,2742,2742,2742,2742,2742,2742,2742,2742,2742,2742,2742,2742,2742,2742,2742,2742,2742,2742,2742,2742,2742
2742,2742,2742,2742,2742,2742,2742,2742,2742,2742,2742,2742,2742,2742,2742,2742,2742,2742,2742,2742,2742,2742,2742,2742,2742,2742,2742,2742,2742,2742,2742,2742,2742,2742,2742,2742,2742,2742,2742,2742,2742,2742,2742,2742,2742,2742,2742,2742,2742,2742
2742,2742,2742,2742,2742,2742,2742,2742,2742,2742,2742,2742,2742,2742,2742,2742,2742,2742,2742,2742,2742,2742,2742,2742,2742,2742,2742,2742,2742,2742,2742,2742,2742,2742,2742,2742,2742,2742,2742,2742,2742,2742,2742,2742,2742,2742,2742,2742,2742,2742
2742,2742,2742,2742,2742,2742,2742,2742,2742,2742,2742,2742,2742,2742,2742,2742,2742,2742,2742,2742,2742,2742,2742,2742,2742,2742,2742,2742,2742,2742,2742,2742,2742,2742,2742,2742,2742,2742,2742,2742,2742,2742,2742,2742,2742,2742,2742,2742,2742,2742
2742,2742,2742,2742,2742,2742,2742,2742,2742,2742,2742,2742,2742,2742,2742,2742,2742,2742,2742,2742,2742,2742,2742,2742,2742,2742,2742,2742,2742,2742,2742,2742,2742,2742,2742,2742,2742,2742,2742,2742,2742,2742,2742,2742,2742,2742,2742,2742,2742,2742
2742,2742,2742,2742,2742,2742,2742,2742,2742,2742,2742,2742,2742,2742,2742,2742,2742,2742,2742,2742,2742,2742,2742,2742,2742,2742,2742,2742,2742,2742,2742,2742,2742,2742,2742,2742,2742,2742,2742,2742,2742,2742,2742,2742,2742,2742,2742,2742,2742,2742
2742,2742,2742,2742,2742,2742,2742,2742,2742,2742,2742,2742,2742,2742,2742,2742,2742,2742,2742,2742,2742,2742,2742,2742,2742,2742,2742,2742,2742,2742,2742,2742,2742,2742,2742,2742,2742,2742,2742,2742,2742,2742,2742,2742,2742,2742,2742,2742,2742,2742
2742,2742,2742,2742,2742,2742,2742,2742,2742,2742,2742,2742,2742,2742,2742,2742,2742,2742,2742,2742,2742,2742,2742,2742,2742,2742,2742,2742,2742,2742,2742,2742,2742,2742,2742,2742,2742,2742,2742,2742,2742,2742,2742,2742,2742,2742,2742,2742,2742,2742
2742,2742,2742,2742,2742,2742,2742,2742,2742,2742,2742,2742,2742,2742,2742,2742,2742,2742,2742,2742,2742,2742,2742,2742,2742,2742,2742,2742,2742,2742,2742,2742,2742,2742,2742,2742,2742,2742,2742,2742,2742,2742,2742,2742,2742,2742,2742,2742,2742,2742
2742,2742,2742,2742,2742,2742,2742,2742,2742,2742,2742,2742,2742,2742,2742,2742,2742,2742,2742,2742,2742,2742,2742,2742,2742,2742,2742,2742,2742,2742,2742,2742,2742,2742,2742,2742,2742,2742,2742,2742,2742,2742,2742,2742,2742,2742,2742,2742,2742,2742
2742,2742,2742,2742,2742,2742,2742,2742,2742,2742,2742,2742,2742,2742,2742,2742,2742,2742,2742,2742,2742,2742,2742,2742,2742,2742,2742,2742,2742,2742,2742,2742,2742,2742,2742,2742,2742,2742,2742,2742,2742,2742,2742,2742,2742,2742,2742,2742,2742,2742
