346,347,346,347,346,347,346,347,346,347,346,347,346,347,346,347,346,347,346,347,346,347,346,347,346,347,346,347,346,347,346,347,346,347,346,347,346,347,346,347,346,347,346,347,346,347,346,347,346,347,346,347,346,347,346,347,346,347,346,347,346,347,346,347,346,347,346,347
409,410,409,410,409,410,409,410,409,410,409,410,409,410,409,410,409,410,409,410,409,410,409,410,409,410,409,410,409,410,409,410,409,410,409,410,409,410,409,410,409,410,409,410,409,410,409,410,409,410,409,410,409,410,409,410,409,410,409,410,409,410,409,410,409,410,409,410
346,347,346,347,346,347,346,347,346,347,346,347,346,347,346,347,346,347,346,347,346,347,346,347,346,347,346,347,346,347,346,347,346,347,346,347,346,347,346,347,346,347,346,347,346,347,346,347,346,347,346,347,346,347,346,347,346,347,346,347,346,347,346,347,346,347,346,347
409,410,409,410,409,410,409,410,409,410,409,410,409,410,409,410,409,410,409,410,409,410,409,410,409,410,409,410,409,410,409,410,409,410,409,410,409,410,409,410,409,410,409,410,409,410,409,410,409,410,409,410,409,410,409,410,409,410,409,410,409,410,409,410,409,410,409,410
346,347,346,347,346,347,346,347,346,347,346,347,346,347,346,347,346,347,346,347,346,347,346,347,346,347,346,347,346,347,346,347,346,347,346,347,346,347,346,347,346,347,346,347,346,347,346,347,346,347,346,347,346,347,346,347,346,347,346,347,346,347,346,347,346,347,346,347
409,410,409,410,409,410,409,410,409,410,409,410,409,410,409,410,409,410,409,410,409,410,409,410,409,410,409,410,409,410,409,410,409,410,409,410,409,410,409,410,409,410,409,410,409,410,409,410,409,410,409,410,409,410,409,410,409,410,409,410,409,410,409,410,409,410,409,410
346,347,346,347,346,347,346,347,346,347,346,347,346,347,346,347,346,347,346,347,346,347,346,347,346,347,346,347,346,347,346,347,346,347,346,347,346,347,346,347,346,347,346,347,346,347,346,347,346,347,346,347,346,347,346,347,346,347,346,347,346,347,346,347,346,347,346,347
409,410,409,410,409,410,409,410,409,410,409,410,409,410,409,410,409,410,409,410,409,410,409,410,409,410,409,410,409,410,409,410,409,410,409,410,409,410,409,410,409,410,409,410,409,410,409,410,409,410,409,410,409,410,409,410,409,410,409,410,409,410,409,410,409,410,409,410
346,347,346,347,346,347,346,347,346,347,346,347,346,347,346,347,346,347,346,347,346,347,346,347,346,347,346,347,346,347,346,347,346,347,346,347,346,347,346,347,346,347,346,347,346,347,346,347,346,347,346,347,346,347,346,347,346,347,346,347,346,347,346,347,346,347,346,347
409,410,409,410,409,410,409,410,409,410,409,410,409,410,409,410,409,410,409,410,409,410,409,410,409,410,409,410,409,410,409,410,409,410,409,410,409,410,409,410,409,410,409,410,409,410,409,410,409,410,409,410,409,410,409,410,409,410,409,410,409,410,409,410,409,410,409,410
346,347,346,347,346,347,346,347,346,347,346,347,346,347,346,347,346,347,346,347,346,347,346,347,346,347,346,347,346,347,346,347,346,347,346,347,346,347,346,347,346,347,346,347,346,347,346,347,346,347,346,347,346,347,346,347,346,347,346,347,346,347,346,347,346,347,346,347
409,410,409,410,409,410,409,410,409,410,409,410,409,410,409,410,409,410,409,410,409,410,409,410,409,410,409,410,409,410,409,410,409,410,409,410,409,410,409,410,409,410,409,410,409,410,409,410,409,410,409,410,409,410,409,410,409,410,409,410,409,410,409,410,409,410,409,410
346,347,346,347,346,347,346,347,346,347,346,347,346,347,346,347,346,347,346,347,346,347,346,347,346,347,346,347,346,347,346,347,346,347,346,347,346,347,346,347,346,347,346,347,346,347,346,347,346,347,346,347,346,347,346,347,346,347,346,347,346,347,346,347,346,347,346,347
409,410,409,410,409,410,409,410,409,410,409,410,409,410,409,410,409,410,409,410,409,410,409,410,409,410,409,410,409,410,409,410,409,410,409,410,409,410,409,410,409,410,409,410,409,410,409,410,409,410,409,410,409,410,409,410,409,410,409,410,409,410,409,410,409,410,409,410
346,347,346,347,346,347,346,347,346,347,346,347,346,347,346,347,346,347,346,347,346,347,346,347,346,347,346,347,346,347,346,347,346,347,346,347,346,347,346,347,346,347,346,347,346,347,346,347,346,347,346,347,346,347,346,347,346,347,346,347,346,347,346,347,346,347,346,347
409,410,409,410,409,410,409,410,409,410,409,410,409,410,409,410,409,410,409,410,409,410,409,410,409,410,409,410,409,410,409,410,409,410,409,410,409,410,409,410,409,410,409,410,409,410,409,410,409,410,409,410,409,410,409,410,409,410,409,410,409,410,409,410,409,410,409,410
346,347,346,347,346,347,346,347,346,347,346,347,346,347,346,347,346,347,346,347,346,347,346,347,346,347,346,347,346,347,346,347,346,347,346,347,346,347,346,347,346,347,346,347,346,347,346,347,346,347,346,347,346,347,346,347,346,347,346,347,346,347,346,347,346,347,346,347
409,410,409,410,409,410,409,410,409,410,409,410,409,410,409,410,409,410,409,410,409,410,409,410,409,410,409,410,409,410,409,410,409,410,409,410,409,410,409,410,409,410,409,410,409,410,409,410,409,410,409,410,409,410,409,410,409,410,409,410,409,410,409,410,409,410,409,410
346,347,346,347,346,347,346,347,346,347,346,347,346,347,346,347,346,347,346,347,346,347,346,347,346,347,346,347,346,347,346,347,346,347,346,347,346,347,346,347,346,347,346,347,346,347,346,347,346,347,346,347,346,347,346,347,346,347,346,347,346,347,346,347,346,347,346,347
409,410,409,410,409,410,409,410,409,410,409,410,409,410,409,410,409,410,409,410,409,410,409,410,409,410,409,410,409,410,409,410,409,410,409,410,409,410,409,410,409,410,409,410,409,410,409,410,409,410,409,410,409,410,409,410,409,410,409,410,409,410,409,410,409,410,409,410
346,347,346,347,346,347,346,347,346,347,346,347,346,347,346,347,346,347,346,347,346,347,346,347,346,347,346,347,346,347,346,347,346,347,346,347,346,347,346,347,346,347,346,347,346,347,346,347,346,347,346,347,346,347,346,347,346,347,346,347,346,347,346,347,346,347,346,347
409,410,409,410,409,410,409,410,409,410,409,410,409,410,409,410,409,410,409,410,409,410,409,410,409,410,409,410,409,410,409,410,409,410,409,410,409,410,409,410,409,410,409,410,409,410,409,410,409,410,409,410,409,410,409,410,409,410,409,410,409,410,409,410,409,410,409,410
346,347,346,347,346,347,346,347,346,347,346,347,346,347,346,347,346,347,346,347,346,347,346,347,346,347,346,347,346,347,346,347,346,347,346,347,346,347,346,347,346,347,346,347,346,347,346,347,346,347,346,347,346,347,346,347,346,347,346,347,346,347,346,347,346,347,346,347
409,410,409,410,409,410,409,410,409,410,409,410,409,410,409,410,409,410,409,410,409,410,409,410,409,410,409,410,409,410,409,410,409,410,409,410,409,410,409,410,409,410,409,410,409,410,409,410,409,410,409,410,409,410,409,410,409,410,409,410,409,410,409,410,409,410,409,410
346,347,346,347,346,347,346,347,346,347,346,347,346,347,346,347,346,347,346,347,346,347,346,347,346,347,346,347,346,347,346,347,346,347,346,347,346,347,346,347,346,347,346,347,346,347,346,347,346,347,346,347,346,347,346,347,346,347,346,347,346,347,346,347,346,347,346,347
409,410,409,410,409,410,409,410,409,410,409,410,409,410,409,410,409,410,409,410,409,410,409,410,409,410,409,410,409,410,409,410,409,410,409,410,409,410,409,410,409,410,409,410,409,410,409,410,409,410,409,410,409,410,409,410,409,410,409,410,409,410,409,410,409,410,409,410
346,347,346,347,346,347,346,347,346,347,346,347,346,347,346,347,346,347,346,347,346,347,346,347,346,347,346,347,346,347,346,347,346,347,346,347,346,347,346,347,346,347,346,347,346,347,346,347,346,347,346,347,346,347,346,347,346,347,346,347,346,347,346,347,346,347,346,347
409,410,409,410,409,410,409,410,409,410,409,410,409,410,409,410,409,410,409,410,409,410,409,410,409,410,409,410,409,410,409,410,409,410,409,410,409,410,409,410,409,410,409,410,409,410,409,410,409,410,409,410,409,410,409,410,409,410,409,410,409,410,409,410,409,410,409,410
346,347,346,347,346,347,346,347,346,347,346,347,346,347,346,347,346,347,346,347,346,347,346,347,346,347,346,347,346,347,346,347,346,347,346,347,346,347,346,347,346,347,346,347,346,347,346,347,346,347,346,347,346,347,346,347,346,347,346,347,346,347,346,347,346,347,346,347
409,410,409,410,409,410,409,410,409,410,409,410,409,410,409,410,409,410,409,410,409,410,409,410,409,410,409,410,409,410,409,410,409,410,409,410,409,410,409,410,409,410,409,410,409,410,409,410,409,410,409,410,409,410,409,410,409,410,409,410,409,410,409,410,409,410,409,410
346,347,346,347,346,347,346,347,346,347,346,347,346,347,346,347,346,347,346,347,346,347,346,347,346,347,346,347,346,347,346,347,346,347,346,347,346,347,346,347,346,347,346,347,346,347,346,347,346,347,346,347,346,347,346,347,346,347,346,347,346,347,346,347,346,347,346,347
409,410,409,410,409,410,409,410,409,410,409,410,409,410,409,410,409,410,409,410,409,410,409,410,409,410,409,410,409,410,409,410,409,410,409,410,409,410,409,410,409,410,409,410,409,410,409,410,409,410,409,410,409,410,409,410,409,410,409,410,409,410,409,410,409,410,409,410
346,347,346,347,346,347,346,347,346,347,346,347,346,347,346,347,346,347,346,347,346,347,346,347,346,347,346,347,346,347,346,347,346,347,346,347,346,347,346,347,346,347,346,347,346,347,346,347,346,347,346,347,346,347,346,347,346,347,346,347,346,347,346,347,346,347,346,347
409,410,409,410,409,410,409,410,409,410,409,410,409,410,409,410,409,410,409,410,409,410,409,410,409,410,409,410,409,410,409,410,409,410,409,410,409,410,409,410,409,410,409,410,409,410,409,410,409,410,409,410,409,410,409,410,409,410,409,410,409,410,409,410,409,410,409,410
346,347,346,347,346,347,346,347,346,347,346,347,346,347,346,347,346,347,346,347,346,347,346,347,346,347,346,347,346,347,346,347,346,347,346,347,346,347,346,347,346,347,346,347,346,347,346,347,346,347,346,347,346,347,346,347,346,347,346,347,346,347,346,347,346,347,346,347
409,410,409,410,409,410,409,410,409,410,409,410,409,410,409,410,409,410,409,410,409,410,409,410,409,410,409,410,409,410,409,410,409,410,409,410,409,410,409,410,409,410,409,410,409,410,409,410,409,410,409,410,409,410,409,410,409,410,409,410,409,410,409,410,409,410,409,410
346,347,346,347,346,347,346,347,346,347,346,347,346,347,346,347,346,347,346,347,346,347,346,347,346,347,346,347,346,347,346,347,346,347,346,347,346,347,346,347,346,347,346,347,346,347,346,347,346,347,346,347,346,347,346,347,346,347,346,347,346,347,346,347,346,347,346,347
409,410,409,410,409,410,409,410,409,410,409,410,409,410,409,410,409,410,409,410,409,410,409,410,409,410,409,410,409,410,409,410,409,410,409,410,409,410,409,410,409,410,409,410,409,410,409,410,409,410,409,410,409,410,409,410,409,410,409,410,409,410,409,410,409,410,409,410
346,347,346,347,346,347,346,347,346,347,346,347,346,347,346,347,346,347,346,347,346,347,346,347,346,347,346,347,346,347,346,347,346,347,346,347,346,347,346,347,346,347,346,347,346,347,346,347,346,347,346,347,346,347,346,347,346,347,346,347,346,347,346,347,346,347,346,347
409,410,409,410,409,410,409,410,409,410,409,410,409,410,409,410,409,410,409,410,409,410,409,410,409,410,409,410,409,410,409,410,409,410,409,410,409,410,409,410,409,410,409,410,409,410,409,410,409,410,409,410,409,410,409,410,409,410,409,410,409,410,409,410,409,410,409,410
346,347,346,347,346,347,346,347,346,347,346,347,346,347,346,347,346,347,346,347,346,347,346,347,346,347,346,347,346,347,346,347,346,347,346,347,346,347,346,347,346,347,346,347,346,347,346,347,346,347,346,347,346,347,346,347,346,347,346,347,346,347,346,347,346,347,346,347
409,410,409,410,409,410,409,410,409,410,409,410,409,410,409,410,409,410,409,410,409,410,409,410,409,410,409,410,409,410,409,410,409,410,409,410,409,410,409,410,409,410,409,410,409,410,409,410,409,410,409,410,409,410,409,410,409,410,409,410,409,410,409,410,409,410,409,410
346,347,346,347,346,347,346,347,346,347,346,347,346,347,346,347,346,347,346,347,346,347,346,347,346,347,346,347,346,347,346,347,346,347,346,347,346,347,346,347,346,347,346,347,346,347,346,347,346,347,346,347,346,347,346,347,346,347,346,347,346,347,346,347,346,347,346,347
409,410,409,410,409,410,409,410,409,410,409,410,409,410,409,410,409,410,409,410,409,410,409,410,409,410,409,410,409,410,409,410,409,410,409,410,409,410,409,410,409,410,409,410,409,410,409,410,409,410,409,410,409,410,409,410,409,410,409,410,409,410,409,410,409,410,409,410
346,347,346,347,346,347,346,347,346,347,346,347,346,347,346,347,346,347,346,347,346,347,346,347,346,347,346,347,346,347,346,347,346,347,346,347,346,347,346,347,346,347,346,347,346,347,346,347,346,347,346,347,346,347,346,347,346,347,346,347,346,347,346,347,346,347,346,347
409,410,409,410,409,410,409,410,409,410,409,410,409,410,409,410,409,410,409,410,409,410,409,410,409,410,409,410,409,410,409,410,409,410,409,410,409,410,409,410,409,410,409,410,409,410,409,410,409,410,409,410,409,410,409,410,409,410,409,410,409,410,409,410,409,410,409,410
346,347,346,347,346,347,346,347,346,347,346,347,346,347,346,347,346,347,346,347,346,347,346,347,346,347,346,347,346,347,346,347,346,347,346,347,346,347,346,347,346,347,346,347,346,347,346,347,346,347,346,347,346,347,346,347,346,347,346,347,346,347,346,347,346,347,346,347
409,410,409,410,409,410,409,410,409,410,409,410,409,410,409,410,409,410,409,410,409,410,409,410,409,410,409,410,409,410,409,410,409,410,409,410,409,410,409,410,409,410,409,410,409,410,409,410,409,410,409,410,409,410,409,410,409,410,409,410,409,410,409,410,409,410,409,410
346,347,346,347,346,347,346,347,346,347,346,347,346,347,346,347,346,347,346,347,346,347,346,347,346,347,346,347,346,347,346,347,346,347,346,347,346,347,346,347,346,347,346,347,346,347,346,347,346,347,346,347,346,347,346,347,346,347,346,347,346,347,346,347,346,347,346,347
409,410,409,410,409,410,409,410,409,410,409,410,409,410,409,410,409,410,409,410,409,410,409,410,409,410,409,410,409,410,409,410,409,410,409,410,409,410,409,410,409,410,409,410,409,410,409,410,409,410,409,410,409,410,409,410,409,410,409,410,409,410,409,410,409,410,409,410
346,347,346,347,346,347,346,347,346,347,346,347,346,347,346,347,346,347,346,347,346,347,346,347,346,347,346,347,346,347,346,347,346,347,346,347,346,347,346,347,346,347,346,347,346,347,346,347,346,347,346,347,346,347,346,347,346,347,346,347,346,347,346,347,346,347,346,347
409,410,409,410,409,410,409,410,409,410,409,410,409,410,409,410,409,410,409,410,409,410,409,410,409,410,409,410,409,410,409,410,409,410,409,410,409,410,409,410,409,410,409,410,409,410,409,410,409,410,409,410,409,410,409,410,409,410,409,410,409,410,409,410,409,410,409,410
415,347,346,347,346,347,346,347,346,347,346,347,346,347,346,347,346,347,346,347,346,347,346,347,346,347,346,347,346,347,346,347,346,347,346,347,346,347,346,347,346,347,346,347,346,347,346,347,346,347,346,347,346,347,346,347,346,347,346,347,346,347,346,347,346,347,346,347
